NO ./texs/north.xpm
SO ./texs/south.xpm
WE ./texs/west.xpm
EA ./texs/east.xpm

F 105,105,105
C 218,165,32

1111111111111111111111111
1000111000111000111000001
1000000111000000000000001
1001000000000000000000001
1111111110111111111000001
1000000000110000011101111
1111011111111101110000001
1111011111111101110101001
1100000011010101110000001
100N000000000000110000001
1000000000000000110101001
1100000111010101111100001
11110111 1110101 10111101
1111111111111111111111111